NO texture/north_text.xpm
SO texture/south_text.xpm
WE texture/west_text.xpm
EA texture/east_text.xpm

F -18,53,25
C 153,204,255

111111111111
1         11
1       0001
100000000011
10S000000001
111111111111
11         1
111111111111
