NO texture/north_text.xpm
EA texture/east_text.xpm
SO texture/south_text.xpm
WE texture/west_text.xpm

C 35,19,73
F 15,6,40

 11111111     0001
1E1000001
100000001
100000001
10000001
10000001
10000001
 1111111 
